"filename", "language", "Python", "JSON", "HTML", "comment", "blank", "total"
"/Users/cobywhitmore/Desktop/Code/Work/Hirsh/HirshBot/robot/centralizedCode/Classes/Graph/edge.py", "Python", 15, 0, 0, 0, 3, 18
"/Users/cobywhitmore/Desktop/Code/Work/Hirsh/HirshBot/robot/centralizedCode/Classes/Graph/graph.py", "Python", 28, 0, 0, 0, 4, 32
"/Users/cobywhitmore/Desktop/Code/Work/Hirsh/HirshBot/robot/centralizedCode/Classes/Graph/node.py", "Python", 10, 0, 0, 0, 1, 11
"/Users/cobywhitmore/Desktop/Code/Work/Hirsh/HirshBot/robot/centralizedCode/Classes/RobotClasses/cart.py", "Python", 19, 0, 0, 4, 5, 28
"/Users/cobywhitmore/Desktop/Code/Work/Hirsh/HirshBot/robot/centralizedCode/Classes/RobotClasses/partRunner.py", "Python", 28, 0, 0, 4, 7, 39
"/Users/cobywhitmore/Desktop/Code/Work/Hirsh/HirshBot/robot/centralizedCode/Classes/environment.py", "Python", 130, 0, 0, 29, 25, 184
"/Users/cobywhitmore/Desktop/Code/Work/Hirsh/HirshBot/robot/centralizedCode/DataFiles/StartUpInformation.json", "JSON", 0, 147, 0, 0, 35, 182
"/Users/cobywhitmore/Desktop/Code/Work/Hirsh/HirshBot/robot/centralizedCode/PathPlanning/pathPlanning.py", "Python", 91, 0, 0, 62, 21, 174
"/Users/cobywhitmore/Desktop/Code/Work/Hirsh/HirshBot/robot/centralizedCode/TestingFiles/A_star.py", "Python", 19, 0, 0, 0, 8, 27
"/Users/cobywhitmore/Desktop/Code/Work/Hirsh/HirshBot/robot/centralizedCode/TestingFiles/OverlayTesting.py", "Python", 39, 0, 0, 3, 12, 54
"/Users/cobywhitmore/Desktop/Code/Work/Hirsh/HirshBot/robot/centralizedCode/TestingFiles/Testing.py", "Python", 24, 0, 0, 4, 8, 36
"/Users/cobywhitmore/Desktop/Code/Work/Hirsh/HirshBot/robot/centralizedCode/WebAndAPI/api.py", "Python", 56, 0, 0, 22, 33, 111
"/Users/cobywhitmore/Desktop/Code/Work/Hirsh/HirshBot/robot/centralizedCode/WebAndAPI/request.py", "Python", 11, 0, 0, 0, 1, 12
"/Users/cobywhitmore/Desktop/Code/Work/Hirsh/HirshBot/robot/centralizedCode/WebAndAPI/templates/dropDownRequest.html", "HTML", 0, 0, 34, 0, 0, 34
"/Users/cobywhitmore/Desktop/Code/Work/Hirsh/HirshBot/robot/centralizedCode/WebAndAPI/templates/index.html", "HTML", 0, 0, 17, 0, 0, 17
"/Users/cobywhitmore/Desktop/Code/Work/Hirsh/HirshBot/robot/centralizedCode/WebAndAPI/templates/requestForm.html", "HTML", 0, 0, 24, 0, 0, 24
"/Users/cobywhitmore/Desktop/Code/Work/Hirsh/HirshBot/robot/centralizedCode/WebAndAPI/templates/requestResult.html", "HTML", 0, 0, 14, 0, 0, 14
"/Users/cobywhitmore/Desktop/Code/Work/Hirsh/HirshBot/robot/centralizedCode/WifiCommunication/communication.py", "Python", 46, 0, 0, 24, 25, 95
"/Users/cobywhitmore/Desktop/Code/Work/Hirsh/HirshBot/robot/centralizedCode/main.py", "Python", 49, 0, 0, 7, 14, 70
"/Users/cobywhitmore/Desktop/Code/Work/Hirsh/HirshBot/robot/centralizedCode/startUp.py", "Python", 36, 0, 0, 1, 5, 42
"/Users/cobywhitmore/Desktop/Code/Work/Hirsh/HirshBot/robot/centralizedCode/testing.py", "Python", 13, 0, 0, 3, 5, 21
"Total", "-", 614, 147, 89, 163, 212, 1225